###############
# *    *    * #
#             #
#      1      #
#             #
#             #
# *    *    * #
###############
# *    *    * #
#             #
#             #
#      2      #
#             #
# *    *    * #
###############