#################
#1             *#
#       *       #
#               #
#               #
#    *     *    #
#               #
#               #
#    *     *    #
#               #
#               #
#    *     *    #
#               #
#               #
#       *       #
#*             2#
#################
