###############
#*     *     *#
#             #
#      1      #
#             #
#             #
#*           *#
###### * ######
#*           *#
#             #
#             #
#      2      #
#             #
#*     *     *#
###############