################
#1            *#
#              #
#  # *#  #  #  #
#              #
#              #
#  #  # *#  #  #
#*             #
#             *#
#  #  #* #  #  #
#              #
#              #
#  #* #  #* #  #
#              #
#*            2#
################