#################
#1             ?#
#               #
# #  #  #  #  # #
#               #
#  ## ## ## ## ?#
#               #
# #  #     #  # #
#      ? ?      #
# #  #     #  # #
#               #
#? ## ## ## ##  #
#               #
# #  #  #  #  # #
#               #
#?             2#
#################
