################
#              #
#              #
#              #
#              #
#              #
#              #
#1            2#
#              #
#              #
#              #
#              #
#              #
#              #
################