#         ###############
#       ##              #
#     ##           #1   #
#   ##      #      ###  #
#  #        #           #
# #         #           #
##          #       #   #
#           #  ####     #
# ###       #           #
#     ####  #           #
#           #    #      #
#     #          #      #
#     #    ###   #      #
#     #          #      #
#     #     #           #
#           #  ###      #
#           #      ###  #
#     ####  #           #
#   #       #          ##
#           #         # #
#           #        #  #
#  ###      #      ##   #
#   2#           ##     #
#              ##       #
###############         #