###############
#             #
#             #
#             #
#             #
#             #
#      1      #
#      2      #
#             #
#             #
#             #
#             #
#             #
###############
