################
#             1#
#              #
# ##############
#              #
#              #
#              #
#              #
#              #
#              #
#              #
#              #
############## #
#              #
#2             #
################
