#########################
#           #           #
#           #           #
#           #           #
#           #           #
#           #           #
#           #     1     #
#           #           #
#           #           #
#           #           #
#           #           #
#                       #
############ ############
#                       #
#           #           #
#           #           #
#           #           #
#           #           #
#     2     #           #
#           #           #
#           #           #
#           #           #
#           #           #
#           #           #
#########################