###############
#      1      #
#             #
#             #
#             #
#     ###     #
#    ## ##    #
#    #   #    #
#    #   #    #
#    ## ##    #
#     ###     #
#             #
#             #
#             #
#      2      #
###############