#########################
#                   #   #
#  #####     #      #   #
#            #      #   #
# ######            # # #
# #                     #
# ########  1  ######## #
#                       #
# ####    ### #      #  #
# #  #      #        #  #
# #  #    # ###      #  #
#                    #  #
#########################
#                   #   #
#  #####     #      #   #
#            #      #   #
# ######            # # #
# #                     #
# ########  2  ######## #
#                       #
# ####    ### #      #  #
# #  #      #        #  #
# #  #    # ###      #  #
#                    #  #
#########################