################
#              #
#              #
#              #
#     #  #     #
#     #  #     #
#   ###  ###   #
#   1      2   #
#   ###  ###   #
#     #  #     #
#     #  #     #
#              #
#              #
#              #
################