###############
#    1        #
# ##### ##### #
# #         # #
# #         # #
# #         # #
# #         # #
#             #
# #         # #
# #         # #
# #         # #
# #         # #
# ##### ##### #
#        2    #
###############
