###############
#1            #
#             #
# #  #  #  #  #
#             #
#             #
#  #  #  #  # #
#             #
# #  #  #  #  #
#             #
#             #
#  #  #  #  # #
#             #
#            2#
###############