###############
#             #
#           1 #
#             #
#   ###########
#   #         #
#   #         #
#   #         #
#   #         #
#   #         #
#   ###########
#             #
#           2 #
#             #
###############