#################
#1              #
#               #
#               #
#               #
#    #######    #
#    #     #    #
#    #     #    #
#    #     #    #
#    #     #    #
#    #     #    #
#    #######    #
#               #
#               #
#               #
#              2#
#################