###############
# ?    ?    ? #
#             #
#      1      #
#             #
#             #
# ?    ?    ? #
###############
# ?    ?    ? #
#             #
#             #
#      2      #
#             #
# ?    ?    ? #
###############
