###############
#1           *#
#      *      #
#             #
#   *     *   #
#             #
#             #
#   *     *   #
#             #
#             #
#   *     *   #
#             #
#      *     b#
#*          b2#
###############
