#################
#1              #
#     #         #
#     ##     #  #
##            ###
#    ### ###    #
#    #?   ?#    #
#       ?       #
#      ? ?      #
#       ?       #
#    #?   ?#    #
#    ### ###    #
###            ##
#  #     ##     #
#         #     #
#              2#
#################
